53,54,4,5,5,5,5,5,5,5,5,5,5,5,5,5
55,56,3,3,3,3,3,3,3,3,3,3,3,3,3,3
4,21,2,2,2,22,0,0,0,0,0,0,0,41,42,42
5,8,0,8,0,8,0,0,0,1,1,1,1,44,45,45
5,0,8,0,8,0,0,0,0,1,1,1,1,44,45,45
5,8,0,8,0,8,0,25,0,1,1,1,1,48,48,48
5,0,8,0,8,0,0,24,0,1,1,1,1,1,1,1
5,21,2,2,2,22,0,23,0,1,1,1,1,1,1,1
5,0,0,0,0,0,0,0,0,0,0,0,0,0,0,0
5,0,8,0,0,0,0,8,0,0,0,0,8,0,0,0
5,51,52,51,52,51,52,51,52,51,52,51,52,51,52,51
5,53,54,53,54,53,54,53,54,53,54,53,54,53,54,53