53,54,4,4,4,4,4,4,4,4,4,4,4,4,4,4
55,56,3,3,3,3,3,3,3,3,3,3,3,3,3,3
4,21,2,2,2,22,0,0,0,0,0,0,0,41,42,42
3,8,0,8,0,8,0,0,0,1,1,1,1,44,45,45
4,0,8,0,8,0,0,0,0,1,1,1,1,44,45,45
3,8,0,8,0,8,0,25,0,1,1,1,1,48,48,48
4,0,8,0,8,0,0,24,0,1,1,1,1,1,1,1
3,21,2,2,2,22,0,23,0,1,1,1,1,1,1,1
4,0,0,0,0,0,0,0,0,0,0,0,0,0,0,0
3,0,8,0,0,0,0,8,0,0,0,0,8,0,0,0
51,52,51,52,51,52,51,52,51,52,51,52,51,52,51,52
53,54,53,54,53,54,53,54,53,54,53,54,53,54,53,54