5,5,5,5,5,5,5,5,5,5,5,5,5,5,4,53
3,3,3,3,3,3,3,3,3,3,3,3,3,3,3,58
42,42,42,42,43,8,8,1,1,1,9,4,9,25,0,53
45,45,45,45,46,8,1,1,1,4,4,3,25,24,0,58
45,45,45,45,46,1,1,1,0,3,3,0,24,24,0,53
48,48,48,48,48,1,1,0,0,0,0,0,24,24,0,58
1,1,1,1,1,1,21,2,2,2,22,0,24,24,0,53
1,1,1,1,1,0,1,1,1,1,1,0,23,24,0,58
0,0,0,0,0,0,0,1,1,1,0,0,0,23,0,53
0,0,8,0,0,0,0,8,1,0,0,8,0,0,0,58
52,51,52,51,52,51,52,51,52,51,52,51,52,51,52,53
54,53,54,53,54,53,54,53,54,53,54,53,54,53,54,58