1,1,1,1,1,1,1,1,1,1,1,1,1,1,1,1
1,1,1,1,1,1,1,1,1,1,1,1,1,1,1,1
1,1,1,1,1,1,0,0,0,0,0,0,0,1,1,1
1,0,0,0,0,0,0,0,0,4,4,4,4,1,1,1
1,0,0,0,0,0,0,0,0,4,4,4,4,1,1,1
1,0,0,0,0,0,0,3,0,4,4,4,4,0,0,5
1,0,0,0,0,0,0,3,0,4,4,4,4,4,4,5
1,2,2,2,2,2,0,2,0,4,4,4,4,4,4,5
1,0,0,0,0,0,0,0,0,0,0,0,0,0,0,5
1,0,0,0,0,0,0,0,0,0,0,0,0,0,0,5
1,0,0,0,0,0,0,0,0,0,0,0,0,0,0,5
1,1,1,1,1,1,1,1,1,1,1,1,1,1,1,1