1,1,1,1,1,1,1,1,1,1,1,1,1,1,1,1
1,1,1,1,1,1,1,1,1,1,1,1,1,1,1,1
1,1,1,1,1,0,0,4,4,4,0,0,3,3,0,1
1,1,1,1,1,0,4,4,4,0,0,1,3,3,0,1
1,1,1,1,1,4,4,4,0,1,1,0,3,3,0,1
5,0,0,0,0,4,4,0,0,0,0,0,3,3,0,1
5,4,4,4,4,4,2,2,2,2,2,0,3,3,0,1
5,4,4,4,4,0,4,4,4,4,4,0,3,3,0,1
5,0,0,0,0,0,0,4,4,4,0,0,0,3,0,1
5,0,0,0,0,0,0,0,4,0,0,0,0,0,0,1
5,0,0,0,0,0,0,0,0,0,0,0,0,0,0,1
1,1,1,1,1,1,1,1,1,1,1,1,1,1,1,1